S      ./textures/sprite.xpm
C  0,191,255
NO./textures/grass.xpm
SO./textures/metal.xpm
F            133 ,    94    ,      66
R  1280           720
WE ./textures/wood.xpm
EA ./textures/brick.xpm


        1111111111111111111111111
        1000000000110000000000001
        1011000001110000002000001
        1001000000000000000000001
111111111011000001110000000000001
100000000011000001110111111111111
11110111111111011100000010001
11110111111111011101010010001
11000000110101011100000000001
10000000000000000000000211001
12000000000000001101012210001
11000001110121011111011110N0111
11110111 1012101 101111010001
11111111 1111111 111111111111
